#village.des
#Village maps

#
#Grass Plain village
#This map is a fun map here yeah with some farmer peasanty guys and they have a cool scythe somewhere 
#- Demo
#
MAZE:"villag-1",' '
GEOMETRY:center,center
MAP
GGGGGGGGGGGGGGGGGGGGGGGGGGGGGGGGGGGGGGGGGGGGGGGGGGGGGGGGGGGGGGGGGGGGGGGGGGG
GGGGGGGGGGGGGGGGGGGGGGGGGGGGGG----GGGGGGGGGGGGGGGGGGGGGGGGGGGGGGGGGGGGGGGGG
GGGGGGGGGGGGGGGGGGGGGGGGGGGGGG|..|GGGGGGGGGGGGGGGGGGGGGGGGGGGGGGGGGGGGGGGGG
GGGGGGGGGGGGGGGGGGGG-----GGGGG|..|GGGGGGG-----GGGGGGGGGGGGGGGGGGGGGGGGGGGGG
GGGGGGGGGGGGGGGGGGGG|...|GGGGG--+-GGGGGGG|...|GGGGGGG----GGGGGGGGGGGGGGGGGG
GGGGGGGGGGGGGGGGGGGG|...+........GGGGGGGG|...|.......+..|GGGGGGGGGGGGGGGGGG
GGGGGGGGGG-----GGGGG|...|GGGG.......GGGGG|...|.GGGGG.|..|GGGGGGGGGGGGGGGGGG
GGGGGGGGGG|...|GGGGG-----GGGG.......GGGGG--+--.GGGGG.----GGGGGGGGGGGGGGGGGG
GGGGGGGGGG|...|GGGGGGGGGGGGGG...{..............GGGGG.GGGGGGGGGGGGGGGGGGGGGG
GGGGGGGGGG|...+..........GGGG.......GGGGGGGGGGGGGGGG.G---------GGGGGGGGGGGG
GGGGGGGGGG-----GGGGGGGG.............GGGGGGGGGGGGGGGG..+.......|GGGGGGGGGGGG
GGGGGGGGGGGGGGGGGGGGG--+-GGGGGGGGGG.GGGG---------GGGGG|.......|GGGGGGGGGGGG
GGGGGGGGGGGGGGGGGGGGG|..|GGGGGGGGGG.....+.......|GGGGG---------GGGGGGGGGGGG
GGGGGGGGGGGGGGGGGGGGG|..|GGGGGGGGGGGGGGG|.......|GGGGGGGGGGGGGGGGGGGGGGGGGG
GGGGGGGGGGGGGGGGGGGGG----GGGGGGGGGGGGGGG---------GGGGGGGGGGGGGGGGGGGGGGGGGG
GGGGGGGGGGGGGGGGGGGGGGGGGGGGGGGGGGGGGGGGGGGGGGGGGGGGGGGGGGGGGGGGGGGGGGGGGGG
GGGGGGGGGGGGGGGGGGGGGGGGGGGGGGGGGGGGGGGGGGGGGGGGGGGGGGGGGGGGGGGGGGGGGGGGGGG
GGGGGGGGGGGGGGGGGGGGGGGGGGGGGGGGGGGGGGGGGGGGGGGGGGGGGGGGGGGGGGGGGGGGGGGGGGG
ENDMAP
RANDOM_PLACES: (12,08), (22,06), (22,13), (45,13), (31,02), (58,11)
# Dungeon Description
REGION:(01,01,73,16),lit,"ordinary"
# Stairs
STAIR:levregion(02,01,05,20),(12,12,13,13),up
STAIR:levregion(72,01,05,20),(0,0,0,0),down
# Doors
DOOR:open,(14,09)
DOOR:open,(24,05)
DOOR:open,(23,11)
DOOR:open,(32,04)
DOOR:open,(40,12)
DOOR:open,(43,07)
DOOR:open,(53,05)
DOOR:open,(54,10)
# Objects
# House loot
# A candle, a tin whistle, a cram ration, a potion, a scroll
OBJECT: '(', "wax candle", place[0]
OBJECT: '(', "tin whistle", place[1]
OBJECT: '%', "cram ration", place[2]
OBJECT: '!', random, place[3]
OBJECT: '?', random, place[4]
OBJECT: ')',"scythe",place[5],uncursed,+3
OBJECT:random,random,random
OBJECT:random,random,random
# Monsters.
MONSTER:'@',"Village Wizard",(54,06)
MONSTER:random,random,random
MONSTER:random,random,random
MONSTER:random,random,random
MONSTER:random,random,random


#
#Fishing lake map
#
MAZE: "villag-2",' '
GEOMETRY: center, center
MAP
-----FFF--------------------------------------   }}}}}}}}}}}}}}}}}}}}}      
|...........|.|.|.|.|...............|........|}}}}}}}}}}}}}}}}}}}}}}}}}}}}  
|-..........|.......|...............|-......-}}}}}}}}}}}}}}}}}}}}}}}}}}}}}}}
|...........+.......|...............|........}}}}}}}}}}}}}}}}}}}}}}}}}}}}}}}
|-..........+.......S...............|-......-}}}}}}}}}}}}}}}}}}}}}}}}}}}}}}}
|...........|.......|...............|........|}}}}}}}}}}}}}}}}}}}}}}}}}}}}} 
|-..........|.......|...............|----+---|}}}}}}}}}}}}}}}}}}}}}}}}}}}}} 
|..|.|.|.|..|.|.|.|.|...............S........|}}}}}}}}}}}}}}}}}}}}}}}}}}}}} 
|--------------------------+-----------------}}}}}}}}}}}}}}}}}}}}}}}}}}}}}}}
|..........................................|.}}}}}}}}}}}}}}}}}}}}}}}}}}}}}}}
|..........................................S..}}}}}}}}}}}}}}}}}}}}}}}}}}}}} 
|.....{....................................|..}}}}}}}}}}}}}}}}}}}}}}}}}}}}} 
|...........---------------+-----------------}}}}}}}}}}}}}}}}}}}}}}}}}}}}}}}
|...........|....|...........................}}}}}}}}}}}}}}}}}}}}}}}}}}}}}}}
|...........|....|...........................}}}}}}}}}}}}}}}}}}}}}}}}}}}}}}}
|--FF---FF--|....|...........................|}}}}}}}}}}}}}}}}}}}}}}}}}}}}} 
|...........|....|...........................|}}}}}}}}}}}}}}}}}}}}}}}}}}}}} 
|...........S....S...........................|}}}}}}}}}}}}}}}}}}}}}}}}}}}}} 
|...........|....|...........................|}}}}}}}}}}}}}}}}}}}}}}}}}}}}  
----------------------------------------------}}}}}}}}}}}}}}}}}}}}}}}}}}}   
ENDMAP

